1 1 1 1 1 1 1 2 2 1 1 1 1 1 1 1
1 1 1 1 1 1 1 2 2 1 1 1 1 1 1 1
1 1 0 0 0 0 0 0 0 0 0 0 0 0 1 1
1 1 0 0 0 0 0 0 0 0 0 0 0 0 1 1
1 1 0 0 0 0 0 0 0 0 0 0 0 0 1 1
1 1 0 0 0 0 0 0 0 0 0 0 0 0 1 1
1 1 0 0 0 0 0 0 0 0 0 0 0 0 1 1
3 3 0 0 0 0 0 0 0 0 0 0 0 0 5 5
3 3 0 0 0 0 0 0 0 0 0 0 0 0 5 5
1 1 0 0 0 0 0 0 0 0 0 0 0 0 1 1
1 1 0 0 0 0 0 0 0 0 0 0 0 0 1 1
1 1 0 0 0 0 0 0 0 0 0 0 0 0 1 1
1 1 0 0 0 0 0 0 0 0 0 0 0 0 1 1
1 1 0 0 0 0 0 0 0 0 0 0 0 0 1 1
1 1 1 1 1 1 1 4 4 1 1 1 1 1 1 1
1 1 1 1 1 1 1 4 4 1 1 1 1 1 1 1